A
800
LIBRARY

# flags_USA_states
EXPORT lib/flags_USA_states/-USA.obj    	flags_USA_states:-USA.obj
EXPORT lib/flags_USA_states/alabama.obj    	flags_USA_states:alabama.obj
EXPORT lib/flags_USA_states/alaska.obj    	flags_USA_states:alaska.obj
EXPORT lib/flags_USA_states/arizona.obj    	flags_USA_states:arizona.obj
EXPORT lib/flags_USA_states/arkansas.obj    	flags_USA_states:arkansas.obj
EXPORT lib/flags_USA_states/california.obj    	flags_USA_states:california.obj
EXPORT lib/flags_USA_states/colorado.obj    	flags_USA_states:colorado.obj
EXPORT lib/flags_USA_states/connecticut.obj    	flags_USA_states:connecticut.obj
EXPORT lib/flags_USA_states/delaware.obj    	flags_USA_states:delaware.obj
EXPORT lib/flags_USA_states/florida.obj    	flags_USA_states:florida.obj
EXPORT lib/flags_USA_states/georgia.obj    	flags_USA_states:georgia.obj
EXPORT lib/flags_USA_states/hawaii.obj    	flags_USA_states:hawaii.obj
EXPORT lib/flags_USA_states/idaho.obj    	flags_USA_states:idaho.obj
EXPORT lib/flags_USA_states/illinois.obj    	flags_USA_states:illinois.obj
EXPORT lib/flags_USA_states/indiana.obj    	flags_USA_states:indiana.obj
EXPORT lib/flags_USA_states/iowa.obj    	flags_USA_states:iowa.obj
EXPORT lib/flags_USA_states/kansas.obj    	flags_USA_states:kansas.obj
EXPORT lib/flags_USA_states/kentucky.obj    	flags_USA_states:kentucky.obj
EXPORT lib/flags_USA_states/louisiana.obj    	flags_USA_states:louisiana.obj
EXPORT lib/flags_USA_states/maine.obj    	flags_USA_states:maine.obj
EXPORT lib/flags_USA_states/maryland.obj    	flags_USA_states:maryland.obj
EXPORT lib/flags_USA_states/massachusetts.obj    	flags_USA_states:massachusetts.obj
EXPORT lib/flags_USA_states/michigan.obj    	flags_USA_states:michigan.obj
EXPORT lib/flags_USA_states/minnesota.obj    	flags_USA_states:minnesota.obj
EXPORT lib/flags_USA_states/mississippi.obj    	flags_USA_states:mississippi.obj
EXPORT lib/flags_USA_states/missouri.obj    	flags_USA_states:missouri.obj
EXPORT lib/flags_USA_states/montana.obj    	flags_USA_states:montana.obj
EXPORT lib/flags_USA_states/nebraska.obj    	flags_USA_states:nebraska.obj
EXPORT lib/flags_USA_states/nevada.obj    	flags_USA_states:nevada.obj
EXPORT lib/flags_USA_states/new_hampshire.obj    	flags_USA_states:new_hampshire.obj
EXPORT lib/flags_USA_states/new_jersey.obj    	flags_USA_states:new_jersey.obj
EXPORT lib/flags_USA_states/new_mexico.obj    	flags_USA_states:new_mexico.obj
EXPORT lib/flags_USA_states/new_york.obj    	flags_USA_states:new_york.obj
EXPORT lib/flags_USA_states/north_carolina.obj    	flags_USA_states:north_carolina.obj
EXPORT lib/flags_USA_states/north_dakota.obj    	flags_USA_states:north_dakota.obj
EXPORT lib/flags_USA_states/ohio.obj    	flags_USA_states:ohio.obj
EXPORT lib/flags_USA_states/oklahoma.obj    	flags_USA_states:oklahoma.obj
EXPORT lib/flags_USA_states/oregon.obj    	flags_USA_states:oregon.obj
EXPORT lib/flags_USA_states/pennsylvania.obj    	flags_USA_states:pennsylvania.obj
EXPORT lib/flags_USA_states/rhode_island.obj    	flags_USA_states:rhode_island.obj
EXPORT lib/flags_USA_states/south_carolina.obj    	flags_USA_states:south_carolina.obj
EXPORT lib/flags_USA_states/south_dakota.obj    	flags_USA_states:south_dakota.obj
EXPORT lib/flags_USA_states/tennessee.obj    	flags_USA_states:tennessee.obj
EXPORT lib/flags_USA_states/texas.obj    	flags_USA_states:texas.obj
EXPORT lib/flags_USA_states/utah.obj    	flags_USA_states:utah.obj
EXPORT lib/flags_USA_states/vermont.obj    	flags_USA_states:vermont.obj
EXPORT lib/flags_USA_states/virginia.obj    	flags_USA_states:virginia.obj
EXPORT lib/flags_USA_states/washington.obj    	flags_USA_states:washington.obj
EXPORT lib/flags_USA_states/west_virginia.obj    	flags_USA_states:west_virginia.obj
EXPORT lib/flags_USA_states/wisconsin.obj    	flags_USA_states:wisconsin.obj
EXPORT lib/flags_USA_states/wyoming.obj    	flags_USA_states:wyoming.obj
EXPORT lib/flags_USA_states/DC_&_Territories/american_samoa.obj    	flags_USA_states/DC_&_Territories:american_samoa.obj
EXPORT lib/flags_USA_states/DC_&_Territories/Distric_of_Columbia.obj    	flags_USA_states/DC_&_Territories:Distric_of_Columbia.obj
EXPORT lib/flags_USA_states/DC_&_Territories/guam.obj    	flags_USA_states/DC_&_Territories:guam.obj
EXPORT lib/flags_USA_states/DC_&_Territories/puerto_rico.obj    	flags_USA_states/DC_&_Territories:puerto_rico.obj
