A
800
LIBRARY

# Flyby_Planes
EXPORT lib/Flyby_Planes/Airliners/737_Air_West.obj    	Flyby_Planes/Airliners:737_Air_West.obj
EXPORT lib/Flyby_Planes/Airliners/737_Air_West_run_L.obj    	Flyby_Planes/Airliners:737_Air_West_run_L.obj
EXPORT lib/Flyby_Planes/Airliners/747_United.obj    	Flyby_Planes/Airliners:747_United.obj
EXPORT lib/Flyby_Planes/Airliners/747_AirIndia.obj    	Flyby_Planes/Airliners:747_AirIndia.obj
EXPORT lib/Flyby_Planes/Airliners/747_AirPacific.obj   	Flyby_Planes/Airliners:747_AirPacific.obj
EXPORT lib/Flyby_Planes/Airliners/747_KoreanAir.obj    	Flyby_Planes/Airliners:747_KoreanAir.obj
EXPORT lib/Flyby_Planes/Airliners/747_Malaysia.obj    	Flyby_Planes/Airliners:747_Malaysia.obj
EXPORT lib/Flyby_Planes/Airliners/747_NWA.obj     	Flyby_Planes/Airliners:747_NWA.obj
EXPORT lib/Flyby_Planes/Airliners/747_Singapore.obj    	Flyby_Planes/Airliners:747_Singapore.obj
EXPORT lib/Flyby_Planes/Airliners/A310.obj    	Flyby_Planes/Airliners:A310.obj
EXPORT lib/Flyby_Planes/Airliners/A310_AirBerlin.obj    	Flyby_Planes/Airliners:A310_AirBerlin.obj
EXPORT lib/Flyby_Planes/Airliners/A310_AirMalta.obj    	Flyby_Planes/Airliners:A310_AirMalta.obj
EXPORT lib/Flyby_Planes/Airliners/A310_China_East.obj    	Flyby_Planes/Airliners:A310_China_East.obj
EXPORT lib/Flyby_Planes/Airliners/A310_easyJet.obj    	Flyby_Planes/Airliners:A310_easyJet.obj
EXPORT lib/Flyby_Planes/Airliners/A310_FedEx.obj    	Flyby_Planes/Airliners:A310_FedEx.obj
EXPORT lib/Flyby_Planes/Airliners/A310_GermanWings.obj    	Flyby_Planes/Airliners:A310_GermanWings.obj
EXPORT lib/Flyby_Planes/Airliners/A310_Singapore.obj    	Flyby_Planes/Airliners:A310_Singapore.obj
EXPORT lib/Flyby_Planes/Airliners/A310_UPS.obj    	Flyby_Planes/Airliners:A310_UPS.obj
EXPORT lib/Flyby_Planes/Airliners/A380.obj    	Flyby_Planes/Airliners:A380.obj
EXPORT lib/Flyby_Planes/Airliners/A380_air_canada.obj   	Flyby_Planes/Airliners:A380_air_canada.obj
EXPORT lib/Flyby_Planes/Airliners/A380_alitalia.obj    	Flyby_Planes/Airliners:A380_alitalia.obj
EXPORT lib/Flyby_Planes/Airliners/A380_british_airways.obj    	Flyby_Planes/Airliners:A380_british_airways.obj
EXPORT lib/Flyby_Planes/Airliners/A380_cathay_pacific.obj    	Flyby_Planes/Airliners:A380_cathay_pacific.obj
EXPORT lib/Flyby_Planes/Airliners/A380_emirates.obj    	Flyby_Planes/Airliners:A380_emirates.obj
EXPORT lib/Flyby_Planes/Airliners/A380_JapanAir.obj   	Flyby_Planes/Airliners:A380_JapanAir.obj
EXPORT lib/Flyby_Planes/Airliners/A380_lufthansa.obj    	Flyby_Planes/Airliners:A380_lufthansa.obj
EXPORT lib/Flyby_Planes/Airliners/A380_Qantas.obj    	Flyby_Planes/Airliners:A380_Qantas.obj
EXPORT lib/Flyby_Planes/Airliners/Falcon_reg.obj    	Flyby_Planes/Airliners:Falcon_reg.obj
EXPORT lib/Flyby_Planes/Airliners/Fedex_Beech.obj    	Flyby_Planes/Airliners:Fedex_Beech.obj
EXPORT lib/Flyby_Planes/Airliners/TUIfly_Beech.obj    	Flyby_Planes/Airliners:TUIfly_Beech.obj
EXPORT lib/Flyby_Planes/Airliners/UPS_Beech.obj   	Flyby_Planes/Airliners:UPS_Beech.obj
EXPORT lib/Flyby_Planes/Airliners/747_United_run_L.obj   	Flyby_Planes/Airliners:747_United_run_L.obj
EXPORT lib/Flyby_Planes/Airliners/A310_run_L.obj    	Flyby_Planes/Airliners:A310_run_L.obj
EXPORT lib/Flyby_Planes/Airliners/A380_run_R.obj    	Flyby_Planes/Airliners:A380_run_R.obj
EXPORT lib/Flyby_Planes/Airliners/Falcon_reg_run_R.obj     	Flyby_Planes/Airliners:Falcon_reg_run_R.obj
EXPORT lib/Flyby_Planes/Airliners/Fedex_Beech_run_L.obj   	Flyby_Planes/Airliners:Fedex_Beech_run_L.obj
EXPORT lib/Flyby_Planes/Airliners/Lear_35_run_R.obj    	Flyby_Planes/Airliners:Lear_35_run_R.obj
EXPORT lib/Flyby_Planes/Airliners/Reg_Com-170_run_R.obj    	Flyby_Planes/Airliners:Reg_Com-170_run_R.obj
EXPORT lib/Flyby_Planes/Float_Planes/C-180_float_run_R.obj    	Flyby_Planes/Float_Planes:C-180_float_run_R.obj
EXPORT lib/Flyby_Planes/Float_Planes/C-180_float.obj    	Flyby_Planes/Float_Planes:C-180_float.obj
EXPORT lib/Flyby_Planes/Float_Planes/C-185_float_run_L.obj    	Flyby_Planes/Float_Planes:C-185_float_run_L.obj
EXPORT lib/Flyby_Planes/Float_Planes/C-185_float.obj    	Flyby_Planes/Float_Planes:C-185_float.obj
EXPORT lib/Flyby_Planes/Float_Planes/CL-415_sea_float_2_tone.obj    	Flyby_Planes/Float_Planes:CL-415_sea_float_2_tone.obj
EXPORT lib/Flyby_Planes/Float_Planes/CL-415_sea_float_run_L_2_tone.obj    	Flyby_Planes/Float_Planes:CL-415_sea_float_run_L_2_tone.obj
EXPORT lib/Flyby_Planes/Float_Planes/CL-415_sea_float_run_L.obj    	Flyby_Planes/Float_Planes:CL-415_sea_float_run_L.obj
EXPORT lib/Flyby_Planes/Float_Planes/CL-415_sea_float.obj    	Flyby_Planes/Float_Planes:CL-415_sea_float.obj
EXPORT lib/Flyby_Planes/Float_Planes/Husky_float_run_L.obj    	Flyby_Planes/Float_Planes:Husky_float_run_L.obj
EXPORT lib/Flyby_Planes/Float_Planes/Husky_float.obj    	Flyby_Planes/Float_Planes:Husky_float.obj
EXPORT lib/Flyby_Planes/Float_Planes/Pa-18_float_Hi_Alt.obj    	Flyby_Planes/Float_Planes:Pa-18_float_Hi_Alt.obj
EXPORT lib/Flyby_Planes/Float_Planes/Pa-18_float_run_R.obj    	Flyby_Planes/Float_Planes:Pa-18_float_run_R.obj
EXPORT lib/Flyby_Planes/Float_Planes/Pa-18_float.obj    	Flyby_Planes/Float_Planes:Pa-18_float.obj
EXPORT lib/Flyby_Planes/GA/Beech_18.obj    	Flyby_Planes/GA:Beech_18.obj
EXPORT lib/Flyby_Planes/GA/Beech_18_green.obj    	Flyby_Planes/GA:Beech_18_green.obj
EXPORT lib/Flyby_Planes/GA/Beech_18_yellow.obj    	Flyby_Planes/GA:Beech_18_yellow.obj
EXPORT lib/Flyby_Planes/GA/Blimp_animated.obj    	Flyby_Planes/GA:Blimp_animated.obj
EXPORT lib/Flyby_Planes/GA/C-172.obj    	Flyby_Planes/GA:C-172.obj
EXPORT lib/Flyby_Planes/GA/C-172_red.obj    	Flyby_Planes/GA:C-172_red.obj
EXPORT lib/Flyby_Planes/GA/C-172_yellow.obj    	Flyby_Planes/GA:C-172_yellow.obj
EXPORT lib/Flyby_Planes/GA/Cessna_152.obj    	Flyby_Planes/GA:Cessna_152.obj
EXPORT lib/Flyby_Planes/GA/Cessna_152_green.obj    	Flyby_Planes/GA:Cessna_152_green.obj
EXPORT lib/Flyby_Planes/GA/Cessna_152_red.obj    	Flyby_Planes/GA:Cessna_152_red.obj
EXPORT lib/Flyby_Planes/GA/Cessna_152_tan.obj    	Flyby_Planes/GA:Cessna_152_tan.obj
EXPORT lib/Flyby_Planes/GA/Cessna_152_yellow.obj    	Flyby_Planes/GA:Cessna_152_yellow.obj
EXPORT lib/Flyby_Planes/GA/Cessna_185.obj    	Flyby_Planes/GA:Cessna_185.obj
EXPORT lib/Flyby_Planes/GA/Cessna_185_green.obj    	Flyby_Planes/GA:Cessna_185_green.obj
EXPORT lib/Flyby_Planes/GA/Cessna_185_tan.obj    	Flyby_Planes/GA:Cessna_185_tan.obj
EXPORT lib/Flyby_Planes/GA/Cessna_185_yellow.obj    	Flyby_Planes/GA:Cessna_185_yellow.obj
EXPORT lib/Flyby_Planes/GA/King_Air_200.obj    	Flyby_Planes/GA:King_Air_200.obj
EXPORT lib/Flyby_Planes/GA/King_Air_200_green.obj    	Flyby_Planes/GA:King_Air_200_green.obj
EXPORT lib/Flyby_Planes/GA/King_Air_200_red.obj    	Flyby_Planes/GA:King_Air_200_red.obj
EXPORT lib/Flyby_Planes/GA/King_Air_200_tan.obj    	Flyby_Planes/GA:King_Air_200_tan.obj
EXPORT lib/Flyby_Planes/GA/King_Air_200_yellow.obj    	Flyby_Planes/GA:King_Air_200_yellow.obj
EXPORT lib/Flyby_Planes/GA/King_Air_200_run_R.obj   	Flyby_Planes/GA:King_Air_200_run_R.obj
EXPORT lib/Flyby_Planes/GA/Tiger_run_R.obj    	Flyby_Planes/GA:Tiger_run_R.obj
EXPORT lib/Flyby_Planes/Gliders/cirrus_glider.obj  	Flyby_Planes/Gliders:cirrus_glider.obj
EXPORT lib/Flyby_Planes/Gliders/cirrus_glider_red.obj  	Flyby_Planes/Gliders:cirrus_glider_red.obj
EXPORT lib/Flyby_Planes/Gliders/cirrus_glider_yellow.obj  	Flyby_Planes/Gliders:cirrus_glider_yellow.obj
EXPORT lib/Flyby_Planes/Gliders/grob_glider.obj  	Flyby_Planes/Gliders:grob_glider.obj
EXPORT lib/Flyby_Planes/Gliders/grob_glider_blue.obj  	Flyby_Planes/Gliders:grob_glider_blue.obj
EXPORT lib/Flyby_Planes/Gliders/grob_glider_green.obj  	Flyby_Planes/Gliders:grob_glider_green.obj
EXPORT lib/Flyby_Planes/Hang_gliders/Hang_glider_800ft.obj    	Flyby_Planes/Hang_gliders:Hang_glider_800ft.obj
EXPORT lib/Flyby_Planes/Hang_gliders/Hang_glider_1100ft.obj    	Flyby_Planes/Hang_gliders:Hang_glider_1100ft.obj
EXPORT lib/Flyby_Planes/Hang_gliders/Hang_glider_1200ft.obj    	Flyby_Planes/Hang_gliders:Hang_glider_1200ft.obj
EXPORT lib/Flyby_Planes/Hang_gliders/Hang_glider_2000ft.obj    	Flyby_Planes/Hang_gliders:Hang_glider_2000ft.obj
EXPORT lib/Flyby_Planes/Hang_gliders/Hang_glider_2500ft.obj    	Flyby_Planes/Hang_gliders:Hang_glider_2500ft.obj
EXPORT lib/Flyby_Planes/Hang_gliders/Hang_glider_thermo_dive.obj    	Flyby_Planes/Hang_gliders:Hang_glider_thermo_dive.obj
EXPORT lib/Flyby_Planes/Helicopters/Apache.obj    	Flyby_Planes/Helicopters:Apache.obj
EXPORT lib/Flyby_Planes/Helicopters/EuroCopter_A350.obj    	Flyby_Planes/Helicopters:EuroCopter_A350.obj
EXPORT lib/Flyby_Planes/Helicopters/EuroCopter_A350_blue.obj    	Flyby_Planes/Helicopters:EuroCopter_A350_blue.obj
EXPORT lib/Flyby_Planes/Helicopters/EuroCopter_A350_white.obj    	Flyby_Planes/Helicopters:EuroCopter_A350_white.obj
EXPORT lib/Flyby_Planes/Helicopters/EuroCopter_AS322.obj    	Flyby_Planes/Helicopters:EuroCopter_AS322.obj
EXPORT lib/Flyby_Planes/Helicopters/EuroCopter_AS322_green.obj    	Flyby_Planes/Helicopters:EuroCopter_AS322_green.obj
EXPORT lib/Flyby_Planes/Helicopters/EuroCopter_AS322_orange.obj    	Flyby_Planes/Helicopters:EuroCopter_AS322_orange.obj
EXPORT lib/Flyby_Planes/Helicopters/EuroCopter_EC135.obj    	Flyby_Planes/Helicopters:EuroCopter_EC135.obj
EXPORT lib/Flyby_Planes/Helicopters/EuroCopter_EC135_red.obj    	Flyby_Planes/Helicopters:EuroCopter_EC135_red.obj
EXPORT lib/Flyby_Planes/Helicopters/EuroCopter_EC135_yellow.obj    	Flyby_Planes/Helicopters:EuroCopter_EC135_yellow.obj
EXPORT lib/Flyby_Planes/Helicopters/Sea_King_flyby.obj    	Flyby_Planes/Helicopters:Sea_King_flyby.obj
EXPORT lib/Flyby_Planes/Helicopters/Sea_King_flyby_creme.obj    	Flyby_Planes/Helicopters:Sea_King_flyby_creme.obj
EXPORT lib/Flyby_Planes/Helicopters/Sea_King_flyby_orange.obj    	Flyby_Planes/Helicopters:Sea_King_flyby_orange.obj
EXPORT lib/Flyby_Planes/Helicopters/CH-47.obj    	Flyby_Planes/Helicopters:CH-47.obj
EXPORT lib/Flyby_Planes/Helicopters/Huey_UH_60.obj    	Flyby_Planes/Helicopters:Huey_UH_60.obj
EXPORT lib/Flyby_Planes/Helicopters/SH-60.obj    	Flyby_Planes/Helicopters:SH-60.obj
EXPORT lib/Flyby_Planes/Military/A-10_lo.obj    	Flyby_Planes/Military:A-10_lo.obj
EXPORT lib/Flyby_Planes/Military/A-10.obj    	Flyby_Planes/Military:A-10.obj
EXPORT lib/Flyby_Planes/Military/B-2.obj    	Flyby_Planes/Military:B-2.obj
EXPORT lib/Flyby_Planes/Military/B-52G.obj    	Flyby_Planes/Military:B-52G.obj
EXPORT lib/Flyby_Planes/Military/B-66_squad.obj    	Flyby_Planes/Military:B-66_squad.obj
EXPORT lib/Flyby_Planes/Military/B-66.obj    	Flyby_Planes/Military:B-66.obj
EXPORT lib/Flyby_Planes/Military/C-17_Globe.obj    	Flyby_Planes/Military:C-17_Globe.obj
EXPORT lib/Flyby_Planes/Military/C-130.obj    	Flyby_Planes/Military:C-130.obj
EXPORT lib/Flyby_Planes/Military/F-4_AG.obj    	Flyby_Planes/Military:F-4_AG.obj
EXPORT lib/Flyby_Planes/Military/F-4_carrier.obj    	Flyby_Planes/Military:F-4_carrier.obj
EXPORT lib/Flyby_Planes/Military/F-4.obj    	Flyby_Planes/Military:F-4.obj
EXPORT lib/Flyby_Planes/Military/F-14_carrier.obj    	Flyby_Planes/Military:F-14_carrier.obj
EXPORT lib/Flyby_Planes/Military/F-15_pair.obj    	Flyby_Planes/Military:F-15_pair.obj
EXPORT lib/Flyby_Planes/Military/F-15.obj    	Flyby_Planes/Military:F-15.obj
EXPORT lib/Flyby_Planes/Military/F-16_carrier.obj    	Flyby_Planes/Military:F-16_carrier.obj
EXPORT lib/Flyby_Planes/Military/F-16_pair.obj    	Flyby_Planes/Military:F-16_pair.obj
EXPORT lib/Flyby_Planes/Military/F-16.obj    	Flyby_Planes/Military:F-16.obj
EXPORT lib/Flyby_Planes/Military/Mig-15_pair.obj    	Flyby_Planes/Military:Mig-15_pair.obj
EXPORT lib/Flyby_Planes/Military/Mig-15.obj    	Flyby_Planes/Military:Mig-15.obj
EXPORT lib/Flyby_Planes/Military/Mig-21_pair.obj    	Flyby_Planes/Military:Mig-21_pair.obj
EXPORT lib/Flyby_Planes/Military/Mig-21.obj    	Flyby_Planes/Military:Mig-21.obj
EXPORT lib/Flyby_Planes/Military/Mirage_pair.obj    	Flyby_Planes/Military:Mirage_pair.obj
EXPORT lib/Flyby_Planes/Military/Mirage.obj    	Flyby_Planes/Military:Mirage.obj
EXPORT lib/Flyby_Planes/Military/A-10_run_L.obj    	Flyby_Planes/Military:A-10_run_L.obj
EXPORT lib/Flyby_Planes/Military/Air_Force_1_run_R.obj    	Flyby_Planes/Military:Air_Force_1_run_R.obj
EXPORT lib/Flyby_Planes/Military/B-2_run_L.obj    	Flyby_Planes/Military:B-2_run_L.obj
EXPORT lib/Flyby_Planes/Military/B-52G_run_L.obj    	Flyby_Planes/Military:B-52G_run_L.obj
EXPORT lib/Flyby_Planes/Military/C-17_Globe_run_L.obj  	Flyby_Planes/Military:C-17_Globe_run_L.obj
EXPORT lib/Flyby_Planes/Military/C-130_run_L.obj   	Flyby_Planes/Military:C-130_run_L.obj
EXPORT lib/Flyby_Planes/Military/F-4_AG_run_R.obj    	Flyby_Planes/Military:F-4_AG_run_R.obj
EXPORT lib/Flyby_Planes/Military/F-4_run_L.obj    	Flyby_Planes/Military:F-4_run_L.obj
EXPORT lib/Flyby_Planes/Military/F-14_run_L.obj    	Flyby_Planes/Military:F-14_run_L.obj
EXPORT lib/Flyby_Planes/Military/F-15_run_R.obj   	Flyby_Planes/Military:F-15_run_R.obj
EXPORT lib/Flyby_Planes/Military/F-16_run_L.obj    	Flyby_Planes/Military:F-16_run_L.obj
EXPORT lib/Flyby_Planes/Military/Mig-15_run_L.obj   	Flyby_Planes/Military:Mig-15_run_L.obj
EXPORT lib/Flyby_Planes/Military/Mig-21_run_L.obj  	Flyby_Planes/Military:Mig-21_run_L.obj
EXPORT lib/Flyby_Planes/Military/Mirage_run_L.obj   	Flyby_Planes/Military:Mirage_run_L.obj
EXPORT lib/Flyby_Planes/WW_I/Alb_DII.obj    	Flyby_Planes/WW_I:Alb_DII.obj
EXPORT lib/Flyby_Planes/WW_I/Alb_DIII.obj    	Flyby_Planes/WW_I:Alb_DIII.obj
EXPORT lib/Flyby_Planes/WW_I/D_VII.obj    	Flyby_Planes/WW_I:D_VII.obj
EXPORT lib/Flyby_Planes/WW_I/DR_1_run_L.obj    	Flyby_Planes/WW_I:DR_1_run_L.obj
EXPORT lib/Flyby_Planes/WW_I/DR_1.obj    	Flyby_Planes/WW_I:DR_1.obj
EXPORT lib/Flyby_Planes/WW_I/SPAD_XIII_run_L.obj    	Flyby_Planes/WW_I:SPAD_XIII_run_L.obj
EXPORT lib/Flyby_Planes/WW_I/SPAD_XIII.obj    	Flyby_Planes/WW_I:SPAD_XIII.obj
EXPORT lib/Flyby_Planes/WW_II/Bf_110_run_R.obj    	Flyby_Planes/WW_II:Bf_110_run_R.obj
EXPORT lib/Flyby_Planes/WW_II/Bf_110.obj    	Flyby_Planes/WW_II:Bf_110.obj
EXPORT lib/Flyby_Planes/WW_II/C-47.obj    	Flyby_Planes/WW_II:C-47.obj
EXPORT lib/Flyby_Planes/WW_II/F-6_carrier.obj    	Flyby_Planes/WW_II:F-6_carrier.obj
EXPORT lib/Flyby_Planes/WW_II/F-6_carrier_WhDn.obj    	Flyby_Planes/WW_II:F-6_carrier_WhDn.obj
EXPORT lib/Flyby_Planes/WW_II/F-6_pair.obj    	Flyby_Planes/WW_II:F-6_pair.obj
EXPORT lib/Flyby_Planes/WW_II/F-6_run_L.obj    	Flyby_Planes/WW_II:F-6_run_L.obj
EXPORT lib/Flyby_Planes/WW_II/f-6.obj    	Flyby_Planes/WW_II:f-6.obj
EXPORT lib/Flyby_Planes/WW_II/Fw-190_run_L.obj    	Flyby_Planes/WW_II:Fw-190_run_L.obj
EXPORT lib/Flyby_Planes/WW_II/Fw-190.obj    	Flyby_Planes/WW_II:Fw-190.obj
EXPORT lib/Flyby_Planes/WW_II/G-4M_run_R.obj    	Flyby_Planes/WW_II:G-4M_run_R.obj
EXPORT lib/Flyby_Planes/WW_II/G-4M.obj    	Flyby_Planes/WW_II:G-4M.obj
EXPORT lib/Flyby_Planes/WW_II/He-111_run_R.obj    	Flyby_Planes/WW_II:He-111_run_R.obj
EXPORT lib/Flyby_Planes/WW_II/He-111.obj    	Flyby_Planes/WW_II:He-111.obj
EXPORT lib/Flyby_Planes/WW_II/He-177_run_L.obj    	Flyby_Planes/WW_II:He-177_run_L.obj
EXPORT lib/Flyby_Planes/WW_II/He-177.obj    	Flyby_Planes/WW_II:He-177.obj
EXPORT lib/Flyby_Planes/WW_II/Italian_Re-2000.obj    	Flyby_Planes/WW_II:Italian_Re-2000.obj
EXPORT lib/Flyby_Planes/WW_II/Ju-87_Stuka.obj    	Flyby_Planes/WW_II:Ju-87_Stuka.obj
EXPORT lib/Flyby_Planes/WW_II/Ki-43_carrier.obj    	Flyby_Planes/WW_II:Ki-43_carrier.obj
EXPORT lib/Flyby_Planes/WW_II/Ki-43_dive.obj    	Flyby_Planes/WW_II:Ki-43_dive.obj
EXPORT lib/Flyby_Planes/WW_II/Ki-43.obj    	Flyby_Planes/WW_II:Ki-43.obj
EXPORT lib/Flyby_Planes/WW_II/Lancaster_run_L.obj    	Flyby_Planes/WW_II:Lancaster_run_L.obj
EXPORT lib/Flyby_Planes/WW_II/Lancaster.obj    	Flyby_Planes/WW_II:Lancaster.obj
EXPORT lib/Flyby_Planes/WW_II/Me_109.obj    	Flyby_Planes/WW_II:Me_109.obj
EXPORT lib/Flyby_Planes/WW_II/Me_262.obj    	Flyby_Planes/WW_II:Me_262.obj
EXPORT lib/Flyby_Planes/WW_II/Mosquito.obj    	Flyby_Planes/WW_II:Mosquito.obj
EXPORT lib/Flyby_Planes/WW_II/P-38_run_R.obj    	Flyby_Planes/WW_II:P-38_run_R.obj
EXPORT lib/Flyby_Planes/WW_II/P-38.obj    	Flyby_Planes/WW_II:P-38.obj
EXPORT lib/Flyby_Planes/WW_II/P-40_run_R.obj    	Flyby_Planes/WW_II:P-40_run_R.obj
EXPORT lib/Flyby_Planes/WW_II/P-40.obj    	Flyby_Planes/WW_II:P-40.obj
EXPORT lib/Flyby_Planes/WW_II/P-51.obj    	Flyby_Planes/WW_II:P-51.obj
EXPORT lib/Flyby_Planes/WW_II/SBD_carrier.obj    	Flyby_Planes/WW_II:SBD_carrier.obj
EXPORT lib/Flyby_Planes/WW_II/SBD_carrier_WhDn.obj    	Flyby_Planes/WW_II:SBD_carrier_WhDn.obj
EXPORT lib/Flyby_Planes/WW_II/SBD_dive.obj    	Flyby_Planes/WW_II:SBD_dive.obj
EXPORT lib/Flyby_Planes/WW_II/SBD_run_L.obj    	Flyby_Planes/WW_II:SBD_run_L.obj
EXPORT lib/Flyby_Planes/WW_II/Spitfire_run_R.obj    	Flyby_Planes/WW_II:Spitfire_run_R.obj
EXPORT lib/Flyby_Planes/WW_II/Spitfire.obj    	Flyby_Planes/WW_II:Spitfire.obj
EXPORT lib/Flyby_Planes/WW_II/Swordfish_carrier.obj    	Flyby_Planes/WW_II:Swordfish_carrier.obj
EXPORT lib/Flyby_Planes/WW_II/Yak-50_dive.obj    	Flyby_Planes/WW_II:Yak-50_dive.obj
EXPORT lib/Flyby_Planes/WW_II/Yak-50_run_L.obj    	Flyby_Planes/WW_II:Yak-50_run_L.obj
EXPORT lib/Flyby_Planes/WW_II/Yak-50.obj    	Flyby_Planes/WW_II:Yak-50.obj
EXPORT lib/Flyby_Planes/WW_II/Yak-52_run_R.obj    	Flyby_Planes/WW_II:Yak-52_run_R.obj
EXPORT lib/Flyby_Planes/WW_II/Yak-52.obj    	Flyby_Planes/WW_II:Yak-52.obj
EXPORT lib/Flyby_Planes/WW_II/Zero_carrier.obj    	Flyby_Planes/WW_II:Zero_carrier.obj
EXPORT lib/Flyby_Planes/WW_II/Zero_carrier_WhDn.obj    	Flyby_Planes/WW_II:Zero_carrier_WhDn.obj
EXPORT lib/Flyby_Planes/WW_II/Zero_dive.obj    	Flyby_Planes/WW_II:Zero_dive.obj
EXPORT lib/Flyby_Planes/WW_II/Zero_pair.obj    	Flyby_Planes/WW_II:Zero_pair.obj
EXPORT lib/Flyby_Planes/WW_II/Zero_run_L.obj    	Flyby_Planes/WW_II:Zero_run_L.obj
EXPORT lib/Flyby_Planes/WW_II/Zero.obj    	Flyby_Planes/WW_II:Zero.obj

